12:12
0 0 0 0 0 0 0 0 0 0 0 0 
17 17 17 17 17 0 17 17 17 17 0 0 
0 0 0 0 17 32 17 0 0 17 0 0 
0 96 0 0 17 0 17 0 0 17 0 0 
0 0 0 0 17 0 17 0 53 17 0 0 
0 0 0 0 17 0 17 0 0 17 0 0 
0 0 0 0 0 0 0  0 0 17 0 0 
0 18 32 18 0 0 0 32 0 17 0 0 
0 18 18 18 0 0 0 0 0 17 0 0 
0 0 0 0 96 0 0 0 0 17 0 0 
38 18 18 18 18 17 17 17 17 17 37 0 
32 0 0 0 0 0 0 0 0 0 0 0 
