12:12
00 96 00 00 00 00 00 17 00 00 61 00 
00 18 18 00 00 00 00 00 00 00 00 00 
00 00 81 00 17 17 17 17 00 00 00 00 
00 00 00 00 17 18 00 17 00 00 00 00 
18 00 00 18 17 00 00 17 18 00 00 18 
00 00 00 00 37 00 00 17 00 00 00 00 
00 00 96 00 37 00 20 17 00 17 17 00 
00 32 32 00 17 00 00 17 00 00 00 00 
18 00 00 18 17 00 00 17 18 00 00 18 
00 00 00 00 17 17 17 17 00 00 00 00 
00 00 00 00 00 00 00 00 00 17 17 00 
00 84 00 00 17 00 00 00 00 00 96 00 
