12:12
00 00 00 17 00 00 00 00 00 00 00 00 
00 37 00 00 00 34 00 17 00 00 00 00 
00 00 00 18 18 18 18 18 18 18 00 00 
00 00 00 00 00 00 00 00 00 18 00 00 
00 18 00 00 18 18 18 00 00 18 00 00 
00 18 00 18 00 00 00 37 00 18 00 96 
00 00 00 18 00 60 00 00 00 18 00 00 
00 32 00 17 17 17 17 17 17 18 00 00 
32 00 32 17 00 00 83 00 00 18 00 00 
00 38 00 17 00 17 17 00 64 18 00 00 
32 00 32 00 00 00 96 00 00 18 00 00 
00 32 00 17 00 00 00 00 00 18 57 00 
