12:12
00 84 00 17 64 00 00 17 00 00 00 00 
00 00 00 17 00 37 00 17 00 00 18 00 
00 96 00 17 00 00 00 00 00 00 00 00 
00 00 00 17 17 17 17 17 00 00 17 38 
18 00 18 17 00 00 00 00 00 00 17 00 
00 00 00 00 00 38 00 00 00 00 17 00 
00 00 00 00 00 00 00 00 00 00 17 00 
18 00 18 17 18 00 00 18 17 17 18 00 
00 00 00 17 00 00 00 00 00 00 18 00 
00 00 00 17 00 96 00 00 18 00 00 00 
00 00 00 17 00 00 00 00 18 00 58 00 
00 55 00 17 00 00 00 00 18 00 00 00 
