12:12
00 00 00 00 00 00 00 00 00 00 00 00 
17 17 17 17 17 00 17 17 17 17 00 00 
00 00 82 00 17 32 17 00 00 17 00 00 
00 96 00 00 17 00 17 00 00 17 00 00 
00 00 00 00 17 00 17 00 53 17 00 00 
00 00 00 00 17 00 17 00 00 17 00 00 
00 00 00 00 00 00 00 00 00 17 00 00 
00 18 32 18 00 00 00 32 00 17 00 00 
00 18 18 18 00 00 00 00 00 17 00 00 
00 00 00 00 96 00 00 00 00 17 00 00 
38 18 18 18 18 17 17 17 17 17 37 00 
32 49 00 00 00 00 00 00 00 00 00 00 
