12:12
00 00 00 00 00 00 00 00 00 00 00 00 
17 17 17 00 17 00 17 17 17 17 00 00 
00 00 00 00 17 32 17 64 00 17 00 00 
32 96 00 00 17 32 17 00 00 17 00 00 
00 00 00 00 17 32 17 00 96 17 00 00 
00 00 00 00 17 17 17 00 00 17 00 00 
00 00 00 00 00 00 00  00 00 17 00 00 
00 18 18 18 00 00 00 37 00 17 00 00 
00 18 84 18 00 00 00 00 00 17 00 00 
00 00 00 00 96 00 00 00 00 17 00 00 
32 17 17 17 17 17 17 17 17 17 38 00 
00 00 51 00 00 00 00 00 00 00 00 00 
