12:12
00 96 00 00 00 00 00 17 00 62 00 00 
00 18 18 00 00 00 00 17 00 00 00 00 
00 00 81 00 17 00 00 17 00 00 00 00 
00 00 00 00 17 18 00 17 00 38 32 00 
18 00 00 18 17 00 00 17 18 00 00 18 
00 00 00 00 17 00 00 17 00 00 00 00 
00 00 96 00 17 00 59 17 00 17 17 00 
00 32 32 00 17 00 00 17 00 00 00 00 
18 00 00 18 17 00 00 17 18 00 00 18 
00 00 00 00 17 00 18 17 00 00 00 00 
00 00 00 00 17 00 00 00 00 17 17 00 
00 84 64 00 17 00 00 00 00 00 96 00 
