12:12
00 00 00 00 00 00 00 17 00 53 17 00 
17 17 17 32 17 00 00 17 00 00 17 00 
00 00 00 00 17 00 00 17 00 00 17 84 
00 00 00 00 17 00 00 17 00 00 17 00 
00 96 81 00 18 00 00 00 00 00 17 00 
00 00 00 18 00 00 00 18 00 00 17 00 
00 00 00 18 00 00 00 00 00 00 17 00 
32 18 18 18 00 17 17 17 17 32 18 00 
00 00 00 18 00 00 00 96 00 00 18 00 
00 00 00 18 00 00 00 18 00 00 18 00 
00 56 00 18 00 00 00 00 00 00 00 00 
00 00 00 18 00 00 00 00 00 00 64 00 
