12:12
00 00 00 00 00 00 00 00 54 00 17 00 
17 00 17 32 17 00 18 17 17 18 00 00 
00 00 00 00 17 00 18 00 00 18 00 00 
00 00 00 00 17 00 18 00 51 18 96 00 
00 96 00 00 18 18 18 00 00 18 00 00 
00 00 00 18 00 00 00 00 00 00 00 00 
00 00 00 18 00 00 00 00 00 00 00 00 
32 18 36 18 00 17 17 17 17 17 00 00 
00 18 00 18 00 17 00 86 00 17 00 00 
00 00 00 00 00 17 00 00 00 17 00 00 
32 18 18 18 17 00 00 00 00 17 00 00 
00 64 00 00 00 00 00 00 96 00 00 00 
