12:12
0 0 0 0 0 0 0 0 0 0 0 0 
17 0 17 0 0 0 17 17 17 17 0 0 
0 0 0 0 17 32 17 0 0 17 0 0 
32 96 0 0 17 32 17 0 0 17 0 0 
0 0 0 0 17 32 17 0 96 17 0 0 
0 0 17 0 17 18 17 0 0 17 0 0 
0 0 0 0 0 0 0  0 0 17 0 0 
0 18 32 18 0 0 0 32 0 17 0 0 
0 18 17 18 0 0 0 0 0 17 0 0 
0 0 0 0 0 0 0 0 0 17 0 0 
32 17 17 18 18 18 17 17 17 17 38 0 
32 0 48 0 0 0 0 0 0 0 0 0
